***      ***
*          *
*          *
*          *
*          *
*          *
*          *
*          *
*          *
*          *
*          *
*          *
*          *
*          *
*          *
*          *
*          *
*          *
*          *
*          *
*          *
************
